-----------------------------------------------------------------------------------------------------------------------------------------
----------------------1111111111111111111111111111111111111111111-----------1111111111111111111-----------111111111111111111111111111111-
----------------------1------1------1------1------1------1------1-----------1--------1--------1-----------1--------1---------1---------1-
------1111111---------1------1------1------1------1------1------1-----------1--------1--------1-----------1--------1---------1---------1-
------1-----1---------1------1------1------1------1------1------1-----------1--------1--------1-----------1--------1---------1---------1-
------1-----1---------1------1------1------1------1------1------1--------------------1--------------------1--------1---------1---------1-
------1-----1---------1------1------1------1------1------1------1--------------------1--------------------1--------1---------1---------1-
------1---------------111--11111--11111--11111--11111--11111--111-----------1--------1--------1-----------1--------1---------1---------1-
------1---------------------------------------------------------------------1--------1--------1-----------1--------1---------1---------1-
------1-----1----N-------N-------N------N-----N-------N------N--------N-----1111111111111111111-----------1111--1111111--11111111---1111-
------1111111---------------------------------------------------------------1--------1--------1------------------------------------------
----------------------------------------------------------------------------1--------1--------1------------------------------------------
----------------------11111111111--11111111--111111111111111111111-------------------1---------------------------------------------------
------1111111---------1------1--------1---------1----------------1----N--------------1--------------N---------N---------N---------N------
------1-----1---------1------1--------1---------1----------------1----------1--------1--------1------------------------------------------
------1-----1---------1------1--------1---------1----------------1----------1--------1--------1------------------------------------------
------1----------------------1--------1---------1----------------1----------1111111111111111111-----------1111--11111111--11111111--1111-
------1----------N-----------1--------1---------1---------------------------1--------1--------1-----------1--------1---------1---------1-
------1-----1---------1------11111111111111111111---------------------N-----1--------1--------1-----------1--------1---------1---------1-
------1-----1---------11111111------------------1------------------------------------1--------------------1--------1---------1---------1-
------1111111---------1------1------------------1----------------1-------------------1--------------N-----1--------1---------1---------1-
-----------------------------1------------------1----------------1----------1--------1--------1-----------1--------1---------1---------1-
-----------------N-----------1------------------1----------------1----------1--------1--------1-----------1--------1---------1---------1-
------1111111---------1------1------------------1----------------1----------1--------1--------1-----------1--------1---------1---------1-
------1-----1---------11111111111---111111---111111111111111111111----------1111111111111111111-----------111111111111111111111111111111-
------1-----1----------------------------------------------------------------------------------------------------------------------------
------1----------------------------------------------------------------------------------------------------------------------------------
------1----------N---------N------N----------N-----------N------------N-----------------------------N-------------------------N----------
------1-----1----------------------------------------------------------------------------------------------------------------------------
------1111111----------------------------------------------------------------------------------------------------------------------------
-----------------------------------------------------------------------------------------------------------------------------------------
------111111111--1111111111---11111111111----------11111---111111111111---111111111111111111111-----------1111111111111111111---11111111-
------1-----------1---------------------1----------1-------------1--------------1-------------1-----------1-----------1----------------1-
------1-----------1---------------------1----------1-------------1--------------1-------------1-----------1-----------1----------------1-
------1-----------1--------------------------N-----1-------------1--------------1-------------------N-----------------111111111111111111-
------1-----------1--------------------------------1-------------1--------------1-------------------------------------1----------------1-
------1-----------1---------------------1----------1-------------1--------------1-------------1-----------1-----------1----------------1-
------1-----------11111111111111111111111----------1-------------1--------------1-------------1-----------1-----------1----------------1-
------1-----------1--------------------------------111111111---11111111---111111111111111111111-----------1111111111111111111---11111111-
------1-----------1----------------------------------------------------------------------------------------------------------------------
------1111111111111----------------------------------------------------------------------------------------------------------------------
------------------------------N--------------N------N--------N-----------N--------------------------N---------N--------------N-----------
------11111111111111---------------------------------------------------------------------------------------------------------------------
------1------------1---------------------------------------------------------------------------------------------------------------------
------1------------1--------------------11111111----------111111111------------111111111111111111111111111111---1111111111111---11111111-
------1------------1--------------------1------1----------1-------1------------1---------------------1-----------------1---------------1-
------1---------------------------------1------1----------1-------1------------1---------------------1-----------------1---------------1-
------1---------------------------------1-------------------------1----------------------------------1-----------------1---------------1-
------1---------------------------------1-----------N-------------1------N---------------------------1-----------------1---------------1-
------1------------1--------------------1------1----------1-------1----------------------------------1-----------------1---------------1-
------1------------1--------------------11111111----------111111111------------1---------------------1-----------------1---------------1-
------1------------1-----------------------------------------------------------111111---111111111111111111111---1111111111111---11111111-
------1------------1--------------------11111111----------111111111----------------------------------------------------------------------
------1------------1--------------------1------1----------1-------1----------------------------------------------------------------------
------1------------1--------------------1-------------------------1----------------------------------------------------------------------
------1------------1--------------------1-----------N-------------1------N------------N-----------N----------N-------------N-------------
------1------------1--------------------1------1----------1-------1----------------------------------------------------------------------
------1---------------------------------1------1----------1-------1----------------------------------------------------------------------
------1---------------------------------11111111----------1-------1----------------------------------------------------------------------
------1------------1---------11--1111---11111111----------111111111------------111111---111111111---11111111---111111111111---1111111111-
------1------------1---------1------1---1------1----------1-------1------------1-------------1---------------------1-------------------1-
------1------------1---------1------1---1------1----------1-------1------------1-------------1---------------------1-------------------1-
------1------------1---------1------1---1-----------N-------------1------------1-------------1---------------------1-------------------1-
------1------------1---------1------1---1-------------------------1------------1-------------1---------------------1-------------------1-
------1------------1---------1------1---1------1----------1-------1------------1-------------1---------------------1-------------------1-
------11111111111111---------11111111---11111111----------111111111------------111111111111111111111111111111111111111111111111111111111-
-----------------------------------------------------------------------------------------------------------------------------------------